MAPVER1.0
0
7 7
16 1 0 3 1 0 0 1 0 0 0 0 0 0 0 0 0 0 0 0 0 
1 1 0 0 0 0 0 1 0 18 0 0 0 0 0 8 0 0 0 0 0 
1 1 0 0 1 0 0 1 0 8 0 0 0 0 0 0 0 0 0 0 0 
1 0 0 0 0 0 0 0 0 0 0 0 0 0 0 2 0 0 2 0 0 
1 0 0 0 0 0 0 0 0 0 0 0 10 0 0 2 0 0 4 0 0 
1 0 0 1 0 0 1 0 0 0 0 0 1 0 0 1 0 0 1 0 0 
1 0 0 1 0 0 1 0 0 1 0 0 1 0 0 1 0 0 1 0 0 
