MAPVER1.0
0
8 10
1 1 0 1 1 0 1 1 0 1 0 0 1 0 0 1 0 0 1 0 0 1 0 0 1 0 0 1 0 0 
1 1 0 1 0 0 0 1 0 0 0 0 0 0 0 0 0 0 0 0 0 0 0 0 0 0 0 1 0 0 
1 1 0 1 1 0 9 1 0 1 0 0 1 0 0 1 0 0 0 0 0 0 0 0 0 0 0 1 0 0 
1 0 0 0 0 0 18 0 0 0 0 0 9 0 0 0 0 0 0 0 0 9 0 0 0 0 0 1 0 0 
1 0 0 0 0 0 10 0 0 10 0 0 1 0 0 0 0 0 9 0 0 0 0 0 0 0 0 1 0 0 
1 0 0 1 0 0 10 0 0 10 0 0 1 0 0 0 0 0 0 0 0 0 0 0 0 0 0 1 0 0 
1 0 0 1 0 0 1 0 0 1 0 0 1 0 0 1 0 0 1 0 0 2 0 0 1 0 0 1 0 0 
1 0 0 1 0 0 1 0 0 1 0 0 1 0 0 1 0 0 1 0 0 16 0 0 1 0 0 1 0 0 
