MAPVER1.0
0
11 13
1 1 0 16 1 0 1 1 0 1 0 0 1 0 0 1 0 0 1 0 0 1 0 0 1 0 0 1 0 0 1 0 0 1 0 0 1 0 0 
1 1 0 2 0 0 1 1 0 1 0 0 0 0 0 0 0 0 0 0 0 0 0 0 0 0 0 1 0 0 1 0 0 1 0 0 1 0 0 
1 1 0 0 1 0 0 1 0 0 0 0 10 0 0 1 0 0 1 0 0 1 0 0 0 0 0 1 0 0 1 0 0 1 0 0 1 0 0 
1 0 0 0 0 0 1 0 0 0 0 0 1 0 0 0 0 0 0 0 0 0 0 0 0 0 0 1 0 0 1 0 0 1 0 0 1 0 0 
1 0 0 0 0 0 1 0 0 0 0 0 9 0 0 0 0 0 9 0 0 1 0 0 10 0 0 0 0 0 1 0 0 1 0 0 1 0 0 
1 0 0 0 0 0 1 0 0 0 0 0 0 0 0 9 0 0 0 0 0 0 0 0 1 0 0 0 0 0 1 0 0 1 0 0 1 0 0 
1 0 0 0 0 0 10 0 0 1 0 0 9 0 0 0 0 0 9 0 0 0 0 0 1 0 0 0 0 0 1 0 0 1 0 0 1 0 0 
1 0 0 1 0 0 0 0 0 0 0 0 0 0 0 0 0 0 1 0 0 0 0 0 1 0 0 0 0 0 1 0 0 1 0 0 1 0 0 
1 0 0 1 0 0 0 0 0 1 0 0 1 0 0 1 0 0 10 0 0 0 0 0 0 0 0 0 0 0 0 0 0 18 0 0 1 0 0 
1 0 0 6 0 0 0 0 0 0 0 0 0 0 0 0 0 0 0 0 0 1 0 0 1 0 0 0 0 0 0 0 0 0 0 0 1 0 0 
1 0 0 1 0 0 1 0 0 1 0 0 1 0 0 1 0 0 1 0 0 1 0 0 1 0 0 1 0 0 1 0 0 1 0 0 1 0 0 
