MAPVER1.0
0
7 10
1 1 0 1 1 0 1 1 0 1 0 0 1 0 0 1 0 0 1 0 0 1 0 0 1 0 0 1 0 0 
1 1 0 1 0 0 1 1 0 1 0 0 0 0 0 0 0 0 0 0 0 11 0 0 1 0 0 1 0 0 
1 1 0 1 1 0 10 1 0 0 0 0 9 0 0 1 0 0 1 0 0 0 0 0 1 0 0 1 0 0 
1 0 0 10 0 0 10 0 0 9 0 0 0 0 0 9 0 0 0 0 0 0 0 0 18 0 0 1 0 0 
1 0 0 10 0 0 10 0 0 0 0 0 9 0 0 0 0 0 9 0 0 0 0 0 1 0 0 1 0 0 
1 0 0 1 0 0 1 0 0 1 0 0 1 0 0 1 0 0 0 0 0 0 0 0 1 0 0 1 0 0 
1 0 0 1 0 0 1 0 0 1 0 0 1 0 0 1 0 0 1 0 0 1 0 0 1 0 0 1 0 0 
