MAPVER1.0
3
-1
0 HAHAH
-1
0 LALAL
-1
6 3
0 1 0 1 1 0 2 1 0 
3 1 0 4 0 0 5 1 0 
6 1 0 7 1 0 8 1 0 
9 1 0 10 1 0 11 1 0 
12 1 0 13 0 0 14 1 0 
15 1 0 15 1 0 15 1 0 
